                                                                                         x                             
                                                                                         x                             
                                                                                         x                             
                                                    x                     xxx  x         x                             
                                           xxx      x                          x         x                             
                                     xxx            x                 xxx      x         x                             
                                                    x                          x         x                             
                              xxx                   x            xxx           x         x                             
                                                    x                          x                                        
                        xxx                         x                          x                                        
                                                    x       xxx                x                                        
                  xxx                               x             xxx          x                                        
                                                    x                  xxx     x                                        
                       xxx                          x                          x                                        
                                                  xxx                        xxx                                        
                            xxx                   x                        xxx                                                           
                                          xxxxxxxxx                       xxx                                           
                        xxx                                            xx                           x
                       x                                            x  xx                         x x x
                    x x                                           x x        xxxxxx             x x x x x
                   xx                                           x x x                         x x x x x x x
         x        xxx       x            x  xx                x x x x                       x x x x x x x x x
        xx      x                     x         x           x x x x x       x             x x x x x x x x x x x           
xxxxxxxxxx  xxxxx    xxx       xxxxxx             xxxxxxxxx x x x x x xxxxx   x    xxxxxxxx x x x x x x x x x xxxxxxxxxx
xxxxxxxxxx  xxxxx    xxx       xxxxxx             xxxxxxxxx x x x x x xxxxx     x  xxxxxxxx x x x x x x x x x xxxxxxxxxx
xxxxxxxxxx  xxxxx    xxx       xxxxxx             xxxxxxxxx x x x x x xxxxx        xxxxxxxx x x x x x x x x x xxxxxxxxxx
xxxxxxxxxx  xxxxx    xxx       xxxxxx             xxxxxxxxx x x x x x xxxxx        xxxxxxxx x x x x x x x x x xxxxxxxxxx
