                                              x                                                                      x           x
                                              x                                                                      x           x
                                              x                                                                      x           x
                                              x                 xxx      xxx     xxx      xxx      xxx               x           x
                                              x                                                                      x           x
                                              x            xxx      xxx      xxx      xxx      xxx      xxx          x           
                                              x                                                                      x           
                                              x       xxx       xxx      xxx     xxx       xxx      xxx     xxx      x           
                                                                                                                       x
                                                 xxx       xxx       xxx     xxx     xxx       xxx      xxx     xxx              
                                            xxx                                                                     xxx          x
                                             xxxxxxxxxxxxxxxxxxxxxxxxxxxxxxxxxxxxxxxxxxxxxxxxxxxxxxxxxxxxxxxxxxxxxxxxx           x                                                            
                                             xxxxxxxxxxxxxxxxxxxxxxxxxxxxxxxxxxxxxxxxxxxxxxxxxxxxxxxxxxxxxxxxxxxxxxxxx           x                                                           
                                             xx              x                 x                   x                 xxx         x
                                             xx              x                 x                   x                   x         x
                                                             x       x         x        x          x                   x         x
                                                                     x                  x                                        x
                                                                     x                  x                                        x
                                             xxxxxxxxxxxxxxxxxxxxxxxxxxxxxxxxxxxxxxxxxxxxxxxxxxxxxxxxxxxxxxxxxxxxxxxxxx          x
                                                                      t                                                xxxxxxxxxxx
                                                                                                             t          x
                                                                   t                              t                     x
xxxxxxx  x  x  x  x  x  xxxxxxxxxxxx                       t                                     t                      x
xxxxxxx  x  x  x  x  x  x          x                                                                        x           x
xxxxxxx  x  x  x  x  x  x          xxxx   xxx    xxx     xxx    xxx    xxx    xxx   xxx    xxx       x           x      x    
xxxxxxx  x  x  x  x  x  x                                                                                  x           xx
xxxxxxx  x  x  x  x  x  x             xxx    xxx    xxx    xxx    xxx    xxx    xxx    xxx    xxx   xxx    xxxxxxxxxxxxx