                                    t                                                                      t           x
                                    t                                                                      t           x
                                    t                   1        1       1        1        1               t           x
                                    t                 ttt      ttt     ttt      ttt      ttt               t           x
                                    t              1        1        1        1        1        1          t           x
                                    t            ttt      ttt      ttt      ttt      ttt      ttt          t           x
                                    t         1         1        1       1         1        1       1      t           x
                                    t       ttt       ttt      ttt     ttt       ttt      ttt     ttt      t           x
                                         1         1         1       1       1         1        1       1              x
                                       ttt       ttt       ttt     ttt     ttt       ttt      ttt     ttt              x
                                  ttt                                                                     ttt          x
                                 t xxxxxxxxxxxxxxxxxxxxxxxxxxxxxxxxxxxxxxxxxxxxxxxxxxxxxxxxxxxxxxxxxxxxxxxxx           x                                                            
                                t  xtttttttttttttttttttttttttttttttttttttttttttttttttttttttttttttttttttttttt           x                                                           
                               t   xt                                                                      t           x
                            2      xt                                                                      t           x
                        xtttt      tt                   2             2              2                     t           x
                     x  x                             ttt    ttt    ttt     ttt   ttt                                  x
                  x  x  x                                   2              2            2                              x
               x  x  x  x                          ttt    ttt    ttt     ttt   ttt    ttt                              x
            x  x  x  x  x                         2             2             2             2                          x
         x  x  x  x  x  x                       ttt    ttt    ttt     ttt   ttt    ttt    ttt                          x                          
      x  x  x  x  x  x  x                             2              2            2            2                       x
xxxxxxx  x  x  x  x  x  xttttttttttt         ttt    ttt    ttt     ttt   ttt    ttt    ttt   ttt         ttx           x
xxxxxxx  x  x  x  x  x  x                   2            2              2             2            2       x           x
xxxxxxx  x  x  x  x  x  x                 ttt   ttt    ttt     ttt    ttt    ttt    ttt   ttt    ttt       x           x
xxxxxxx  x  x  x  x  x  x                      2             2             2             2            2    x           x
xxxxxxx  x  x  x  x  x  x             ttt    ttt    ttt    ttt    ttt    ttt    ttt    ttt    ttt   ttt    xxxxxxxxxxxxx

























